12 17
     #######     
     #  @  #     
     # ### ##    
#### # # #  #####
#  ### # # .    #
#      # #   $$ #
#   $  # #  ## ##
#  ## ## #     # 
# .   #  #  ## # 
#  ####  # .   # 
####     #  #### 
         ####     
