19 30
   #######        ########    
   #     #        #  ##  #    
#### ### #    #####$    $##   
#  #     ###  #      ## $ #   
#     #    #  # $ $$$##   #   
#     #    #####$  #  ### #   
### ##### ##   #  $# $    #   
#   #  #       #$  #  #####   
#      #   #  ##  ## #  #     
#   #  ####   ## # $ $  #     
##### ##      ## #   #  #     
   #       ####  ##### ###### 
   #   #      #    # $$$ #  ##
   #   #      ## $        $  #
   ######## ############## # #
        # @..................#
        # # ##################
        #   #                 
        #####                 